1111111111111
10010007000C1
1000011111001
1P0011E090001
1111111111111
