1111111111111111111111111111111111
1E00E000E0000001000001000000000001
1010010100100000101001000000010101
1010010010101010C01001000000010101
1P00000000001000000C00000000000011
1111111111111111111111111111111111
